서울시민 모두가 동시에 외치면 무슨 말이 될까?	ㅊㅁㅇㅁㅆ	천만의말씀
사람의 몸무게가 가장 많이 나갈 때는?	ㅊㄷㄸ	철들때
세 사람만 탈 수 있는 차는?	ㅇㅅㅊ	인삼차
먹고 살기 위해 하는 내기는?	ㅁㄴㄱ	모내기
가슴의 무게는?	ㄴㄱ	네근
병아리가 제일 잘 먹는 약은?	ㅃㅇ	삐약
묵은 묵인데 먹지 못하는 묵은?	ㅊㅁ	침묵
물고기 중에서 가장 학벌이 좋은 물고기는?	ㄱㄷㅇ	고등어
창으로 찌르려고 할 때 하는 말은?	ㅊㅍㅎ	창피해
누룽지를 영어로 표현하면?	ㅂㅇㅂㄹㅇ	밥이브라운
남이 먹어야 맛있는 것은?	ㄱㅌ	골탕
이상한 사람들이 모이는 곳은?	ㅊㄱ	치과
직장에서 가장 무서운 상사는?	ㅂㅅㅅ	불상사
먹으면 죽는데 안 먹을 수 없는 것은?	ㄴㅇ	나이
도둑이 훔친 돈을 뭐라고 할까?	ㅅㄱㅁㄴ	슬그머니
세탁소 주인이 가장 좋아하는 차는?	ㄱㄱㅈㅊ	구기자차
텔레토비가 차린 안경점 이름은?	ㅇㅇㅈㅇ	아이조아
‘조금 전에 울다가 그친 사람’을 다섯 글자로 줄이면?	ㅇㄲㅇㅅㄹ	아까운사람
오리는 오리인데, 물속에서만 사는 오리는?	ㄱㅇㄹ	가오리
한쪽 발은 가만히 있고 다른 한쪽 발로 걸어다니는 것은?	ㅋㅍㅅ	컴퍼스	
닭은 닭인데 먹지 못하는 닭은?	ㄲㄷ	까닭
나나가 지구에 왔다. 뽀가 한 말을?	ㅈㄱㅇㄴㄴ	지구온나나
하늘에 해가 없으면 어떻게 되나?	ㅁㅁㄹㄷ	못말린다
이 세상에서 가장 인정이 많은 중국의 학자는?	ㅈㅈ	주자
성경 인물 중 산수를 제일 못하는 사람은?	ㅁㅅ	모세
인도는 지금 몇시일까?	ㅇㄷㄴㅅㅇ	인도네시아
딸기가 도망가면	ㄸㄱㅉ	딸기쨈
귀가 불에 타면?	ㅌㅇㅇ	타이어
자동차가 놀라면?	ㅋㄴㄹㅇ	카놀라유
새가 불에 타면?	ㅌㅈ	타조
어부들이 가장 싫어하는 가수는?	ㅂㅊㅅ	배철수
비가 한시간 동안 내리면?	ㅊㅈㅇㅅㅂ	추적육십분
임금님이 집에가기 싫을때 하는 말은?	ㄱㅅㄹ	궁시렁
사람이 죽지않는 산맥은?	ㅇㄷㅅㅅㅁ	안데스산맥
세계에서 기형아가 가장 많이 태어나는 나라는?	ㄴㅍ	네팔
세계에서 굶는 사람이 가장 많은 나라는?	ㅎㄱㄹ	헝가리
코끼리 마리가 서로 싸워 둘 다 코가 떨어져 나갔다면?	ㄲㄹㄲㄹ	끼리끼리
가장 급하게 만들어 먹은 떡은?	ㅎㄹㅂㄸ	헐레벌떡
할아버지가 좋아하는 돈은?	ㅎㅁㄴ	할머니
덜 뚱뚱한 사람들이 모여사는 동네는?	ㅂㅍㄷ	반포동
울다가 울음이 그친 사람을 5글자로 줄이면?	ㅇㄲㅇㅅㄹ	아까운사람
꽃가게 주인이 제일 싫어하는 곳은?	ㅅㄷㄴ	시드니
둘리가 재학중인 고등학교의 이름은?	ㅂㅎㅌㄱ	빙하타고
우리나라까지 석유가 도착하는데 걸리는 시간은?	ㅇㅇ	오일
세상에서 제일 가난한 왕은?	ㅊㅈㅇㄱ	최저임금
우주인들이 술마시는 곳은?	ㅅㅍㅇㅅㅂ	스페이스바
야구선수가 왕에게 공을 던질때 하는 말은?	ㅅㄱㅎㅇㄴㄷ	송구하옵니다
3월에 대학생들이 강한 이유는?	ㄱㄱㅎㅅ	개강해서
화장실에서 방금 나온 사람은?	ㅇㅂㅅㄹ	일본사람
바람이 귀엽게 부는 지역은?	ㅂㄷ	분당
세상에서 가장 야한 가수는?	ㄷㅂㅊ	다비치
서울이 추운걸 5글자로 줄이면?	ㅅㅇㅅㄹㄷ	서울시립대
딸기가 직장을 잃으면?	ㄸㄱㅅㄹ	딸기시럽
식인종이 우사인볼트를 보면서 하는 말은?	ㅍㅅㅌㅍㄷ	패스트푸드
신발이 화가나면?	ㅅㅂㄲ	신발끈
테니스 동호회에서 편파판정이 가장 심한 연예인은?	ㅇㅇㅇ	유아인
모든 사람을 일으키는 숫자는?	ㄷㅅ	다섯
디지털카메라를 무료로 주는 배우는?	ㄷㅋㅍㄹㅇ	디카프리오